--------------------------------------------------------------------------------------------------------------------------------------------------------------------------------------------------------
--------------------------------------------------------------------------------------------------------------------------------------------------------------------------------------------------------
----------------------------------------------------------------------------------------------------------------------------------------------B---------------------------------------------------------
------------------------------------------------------------------------------------------------------------------B-------------------------------------------------------------------------------------
------------------------------------------------------------------------------------------------M-----------------------X-------------------------------------------------------------------------------
-----------------------------------------------------------------------------B-----------------------------------------XX-------------------------------------------------------------------------------
--------------M---------------------------------?---------------------------------------------------------------------XXX-------------------------------------------------------------------------------
-------------?-------------------------X-----------------------X-------------------XX--------------------------------XXXX------------------------------------------------------------------------------v
--------------------------------------XX----------------------------------------------------------B-----------------XXXXX------------------------------------------------------------------------------f
-------------------------------------XXX---------------------------------------------------------------------------XXXXXX---XXXXXXX--------------------------------------------------------------------f
------------------------------------XXXX--------------------------------------------------------------------------XXXXXXX------------------------------------------------------------------------------f
-------------B--------------------?XXXXX------o----o------------T-----------------------XXXXXXX------------------XXXXXXXX-------------------------------------------------------------------T----------f
--------------------T-------------XXXXXX------------------------|-----------------------------------------------XXXXXXXXX-------------------------------------------------------------------|---?------f
--------------------|------------XXXXXXX------------------------|----------------------------------------------XXXXXXXXXX-------------------------------------------------------------------|----------f
m-------------------|-----------XXXXXXXX----------------E-------|E---E----------------------------------------XXXXXXXXXXX------------------------------------------E------------------------|----------X
XXXXXXXXXXXXXXXXXXXX|XXXXXXXXXXXXXXXXXXXXXXXXXXXXXXXXXXXXXXXXXXX|XXXXXXXXXXXXXX------XXXXXXXXXXXXXXXXXXXXXXXXXXXXXXXXXXXXXXXXXXXX--------XXXXXXXXXXXXXXXXXXXXXXXXXXXXXXXXXXXXXXXXXXXXXXXXXXX|XXXXX-----X
