-------------------------------------------------M------------------------------------------------------------------------------------------------------------------------------------------------------
-----------------?--------------------------------------------------------------------------------------------------------------------------------------------------------------------------------------
---------------------------o----------------------------------------------------------------------------------------------------------------------------------------------------------------------------
--------------------------------------------------------------------------------------------------------------------------------------------------------------------------------------------------------
--------------------------------------------------------------------------------------------------------------------------------------------------------B-----------------------------------------------
-------------------------------------------------------------------------------------------------------------------------------------------------------------------------------------------------BBBB-B-
---------------------------------o----------------------------------------------------------------------------------------------------------------------------------------------------------------------
------------------------------------------------------B--------------??????----------------------------------------------------------------------------------------------------------------------------v
-----------------------------------------------------------------T-------------------------------------------------------------------------------------------------------------------------------------f
-----------------------------------------------------------------|-------------------------------------------------------------------------------------------------------------------------------------f
-----------------------------------------------------------------|-------??????------------------------------------------------------------------------------------------------------------------------f
-----------------------------------------------------------T-----|----X--------------------------------------------------------------------------------------------------------------------T-----------f
-------------------------------B------------XX-------------|-o---|---XX--------------------------------------------------------------------------------------------------------------------|-----------f
-----------------------------------------------------------|-----|--XXX--------------------------------------------------------------------------------------------------------------------|-----------f
m---------------------E----------------------E------E------|-----|-XXXX--------------------------------------------------------------------------------------------------------------------|E----------X
XXXXXXXX-------XXXXXXXXXXXXXMXXXXXXXXXXXXX-X------XX----XXX|----X|XXXXXXXXXXXXXXXXXXXXXXXXXXXXXX-------XXXXXXXXXXXXXXXXXXXXXXXXXXX-XXXXXXXXXXXXXXXXXXXXXXXXXXXXXXXXXXXXXXX-XXXXXXXXXXXXXXXX|XXXXXXXXXXXX
