--------------------------------------------------------------------------------------------------------------------------------------------------------------------------------------------------------
--------------------------------------------------------------------------------------------------------------------------------------------------------------------------------------------------------
--------------------------------------------------------------------------------------------------------------------------------------------------------------------------------------------------------
--------------------------------------------------------------------------------------------------------------------------------------------------------------------------------------------------------
-----------------------------------------------------------------------------------------------------X--------------------------------------------------------------------------------------------------
----------------------------------------------------------------------------------------------------XX--------------------------------------------------------------------------------------------------
------------------------o--------------------------------------------------------------------X-----XXX------------------X-------------------------------------------------------------------------------
---------------------------------------------------------------------------------X----------------XXXX-----------------XX------------------------------------------------------------------------------v
--------------------------------------------------------------------------------XX---------------XXXXX----------------XXX------------------------------------------------------------------------------f
-------------------------------------------------------------------------------XXX--------------XXXXXX---------------XXXX------------------------------------------------------------------------------f
------------------------------------------------------------------------------XXXX-------------XXXXXXX--------------XXXXX---------------------------o--------------------------------------------------f
-----------------------------------------------------------------------------XXXXX------------XXXXXXXX-------------XXXXXX------------------------------------------------------------------------------f
----------------------------------------------------------------------------XXXXXX-----------XXXXXXXXX------------XXXXXXX------------------------------------------------------------------------------f
---------------------------------------------------------------------------XXXXXXX----------XXXXXXXXXX-----------XXXXXXXX------------------------------------------------------------------------------f
m------------------------------------------X--------------------E---------XXXXXXXX---------XXXXXXXXXXX----------XXXXXXXXX------------------------------------------------------------------------------X
XXXXXXXXXXXXXXXXXXXXXXXXXXXXXXXXXXXXXXXXXXXXXXXXXXXXX----X------XXXXXX---XXXXXXXXXXXXXXXXXXXXXXXXXXXXXXXXXXXXXXXXXXXXXXXXXXXXXXXXXXXXXXXXXXXXXXXXXXXXXXXXXXXXXXXXXXXXXXXXXXXXXXXXXXXXXXXXXXXXXXXXXXMXXXX
